0,0,0,0,0,0,0,0,0,0,0,0,0,0,0,0
0,0,0,0,0,0,0,0,0,0,0,0,0,0,0,0
0,0,0,0,0,0,0,0,0,0,0,0,0,0,0,0
0,0,0,0,0,0,0,0,0,0,0,0,0,0,0,0
0,0,17,17,17,17,17,17,0,0,0,0,0,0,0,0
0,0,17,17,17,17,17,17,0,0,0,0,0,0,0,0
0,0,17,17,17,17,17,17,0,0,0,0,0,0,0,0
0,0,17,17,17,17,17,17,0,0,0,0,0,0,0,0
0,0,17,17,17,17,17,17,17,17,17,17,17,17,17,19
0,0,17,17,17,17,17,17,17,17,17,17,17,17,17,19
0,0,0,0,0,0,0,0,0,0,0,0,0,0,0,0
0,0,0,0,0,0,0,0,0,0,0,0,0,0,0,0
