9,9,9,9,9,9,9,9,9,9,9,9,9,9,9,9
9,24,25,25,25,25,25,25,25,25,25,25,25,25,26,9
9,32,9,9,9,9,9,9,9,9,9,9,9,9,34,9
9,32,9,9,9,9,9,9,9,9,9,9,9,9,34,9
9,32,9,9,9,9,9,9,9,9,9,9,9,9,34,9
9,32,9,9,9,9,9,9,9,9,9,9,9,9,34,9
9,32,9,9,9,9,9,9,9,9,9,9,9,9,34,9
9,32,9,9,9,9,9,9,9,9,9,9,9,9,34,9
9,32,9,9,9,9,9,9,9,9,9,9,9,9,34,9
9,32,9,9,9,9,9,9,9,9,9,9,9,9,34,9
9,40,41,41,41,41,41,41,41,41,41,41,41,41,42,9
9,9,9,9,9,9,9,9,9,9,9,9,9,9,9,9